BY	B AY
DIVIDED	D IH V AY D IH D
EIGHT	EY T
EXIT	EH G Z IH T
EXIT(2)	EH K S AH T
FIVE	F AY V
FOUR	F AO R
MINUS	M AY N AH S
NINE	N AY N
OF	AH V
ONE	W AH N
ONE(2)	HH W AH N
OVER	OW V ER
PLUS	P L AH S
POINT	P OY N T
POWER	P AW ER
SEVEN	S EH V AH N
SIX	S IH K S
SUBTRACTED	S AH B T R AE K T IH D
TEN	T EH N
THREE	TH R IY
TIMES	T AY M Z
TWO	T UW
ZERO	Z IY R OW
